############################
#............##............#
#.####.#####.##.#####.####.#
#*####.#####.##.#####.####*#
#..........................#
#.####.##.########.##.####.#
#.####.##.########.##.####.#
#......##....##....##......#
######.#####.##.#####.######
     #.#####.##.#####.#
     #.##..........##.#
######.##.###--###.##.######
..........#      #..........
######.##.########.##.######
     #.##..........##.#
     #.##.########.##.#
######.##.########.##.######
#............##............#
#.####.#####.##.#####.####.#
#....#................#....#
####.#.##.########.##.#.####
####.#.##.########.##.#.####
#......##....##....##......#
#*##########.##.##########*#
#.##########.##.##########.#
#..........................#
############################