############################
#............##............#
#.####.#####.##.#####.####.#
#.####.#####.##.#####.####.#
#..........................#
#.####.##.########.##.####.#
#.####.##.########.##.####.#
#......##....##....##......#
######.#####.##.#####.######
     #.#####.##.#####.#
     #.##..........##.#
######.##.###--###.##.######
..........#      #..........
######.##.########.##.######
     #.##..........##.#
     #.##.########.##.#
######.##.########.##.######
#............##............#
#.####.#####.##.#####.####.#
#....#................#....#
####.#.##.########.##.#.####
####.#.##-########.##.#.####
#......##....##....##......#
#.##########.##.##########.#
#.##########.##.##########.#
#..........................#
############################